#####]####
#D.......#
#.....L..#
#........#
#..###.$.#
#..0.....#
##########