##########
#...B#/..#
#....#..P#
#........]
#...###.##
#.....#.*#
#####]####