##########
#.....*..#
#........#
#...###..D
#.....#..#
#.....#..#
#####D####