##########
#...B#/..#
#....#..P#
#.M......]
#...###.##
#.....#.*#
#####]####