#####D####
#........#
#.....L..#
#........#
#..###...#
#..0.....#
##########