##########
#.B...0..#
#.......Y#
#./.###..D
#.....#.L#
#.....#..#
#####D####