##########
#.B...0..#
#.......H#
#./.###..D
#.....#.L#
#.....#..#
#####D####