##########
#....H...#
#........#
]........#
##.##.^..#
#..>#....#
##########