##########
#.B...*..#
#.......Y#
#...###..D
#.....#.L#
#.....#..#
#####D####