##########
#....H...#
#........#
D........#
#........#
#.!......#
##########