##########
#..Gb....#
#........#
].......H#
##.##.^..#
#..>#....#
##########