##########
#...B#...#
#....#..P#
#........D
#...###.##
#.....#./#
#####D####